%%%%%%%%%%%%%%%%%%%%
%......% GG %......%
%.%%...%%  %%...%%.%
%..................%
%..%%%.%%%%%%.%%%..%
%........P.........%
%..%%%%%   %%%%%%..%
%..........%.......%
%%%%%%%%%%%%%%%%%%%%